hello (hê-lô)=xin chào
goodbye (gút-bai)=tạm biệt
cat (két)=mèo
dog (đog)=chó
house (hau-sơ)=ngôi nhà
tree (trì)=cái cây
flower (flao-ơ)=bông hoa
sun (xăn)=mặt trời
moon (mun)=mặt trăng
star (sta)=ngôi sao
water (wo-tờ)=nước
fire (fai-ờ)=lửa
earth (ớth)=trái đất
sky (skai)=bầu trời
mountain (mao-tin)=núi
river (ri-vờ)=dòng sông
ocean (âu-sần)=đại dương
book (buk)=quyển sách
pen (pen)=cây bút
pencil (pen-xồ)=bút chì
table (tê-bồ)=cái bàn
chair (che)=cái ghế
computer (kơm-piu-tơ)=máy tính
phone (foun)=điện thoại
music (miu-zic)=âm nhạc
food (fu-đờ)=thức ăn
drink (đringk)=đồ uống
sleep (slíp)=ngủ
eat (ít)=ăn
run (răn)=chạy
walk (wo-k)=đi bộ
swim (swịm)=bơi
play (plây)=chơi
read (ri-đ)=đọc
write (rai-t)=viết
sing (sing)=hát
dance (đan-sơ)=nhảy
happy (ha-pi)=vui vẻ
sad (xeđ)=buồn bã
big (big)=lớn
small (smol)=nhỏ
hot (hot)=nóng
cold (kôlđ)=lạnh
good (guđ)=tốt
bad (beđ)=xấu