こんにちは (konnichiwa)=xin chào
さようなら (sayounara)=tạm biệt
猫 (neko)=mèo
犬 (inu)=chó
家 (ie)=nhà
木 (ki)=cây
花 (hana)=hoa
太陽 (taiyou)=mặt trời
月 (tsuki)=mặt trăng
星 (hoshi)=ngôi sao
水 (mizu)=nước
火 (hi)=lửa
地球 (chikyuu)=trái đất
空 (sora)=bầu trời
山 (yama)=núi
川 (kawa)=sông
海 (umi)=biển
本 (hon)=sách
ペン (pen)=bút
机 (tsukue)=bàn
椅子 (isu)=ghế
パソコン (pasokon)=máy tính
電話 (denwa)=điện thoại
音楽 (ongaku)=âm nhạc
食べ物 (tabemono)=thức ăn
飲み物 (nomimono)=đồ uống
寝る (neru)=ngủ
食べる (taberu)=ăn
走る (hashiru)=chạy
歩く (aruku)=đi bộ
泳ぐ (oyogu)=bơi
遊ぶ (asobu)=chơi
読む (yomu)=đọc
書く (kaku)=viết
歌う (utau)=hát
踊る (odoru)=nhảy
嬉しい (ureshii)=vui vẻ
悲しい (kanashii)=buồn bã
大きい (ookii)=lớn
小さい (chiisai)=nhỏ
熱い (atsui)=nóng
寒い (samui)=lạnh
良い (yoi)=tốt
悪い (warui)=xấu