привет (pri-vét)=xin chào
до свидания (đo xvi-đan-i-ya)=tạm biệt
кошка (koch-ka)=mèo
собака (so-ba-ka)=chó
дом (đom)=nhà
дерево (đe-rye-vo)=cây
цветок (tsve-tok)=hoa
солнце (xôn-xê)=mặt trời
луна (lu-na)=mặt trăng
звезда (zvyê-zđa)=ngôi sao
вода (va-đa)=nước
огонь (a-gon)=lửa
земля (zyem-lya)=trái đất
небо (nye-bo)=bầu trời
гора (ga-ra)=núi
река (rye-ka)=sông
океан (a-kyi-an)=đại dương
книга (kni-ga)=sách
ручка (ru-chka)=bút
стол (xtol)=bàn
стул (xtul)=ghế
компьютер (kam-pyu-tyer)=máy tính
телефон (tye-lye-fon)=điện thoại
музыка (mu-zy-ka)=âm nhạc
еда (ye-đa)=thức ăn
напиток (na-pi-tok)=đồ uống
спать (spat)=ngủ
есть (yest)=ăn
бежать (bye-zhat)=chạy
гулять (gu-lyat)=đi bộ
плавать (pla-vat)=bơi
играть (ig-rat)=chơi
читать (chi-tat)=đọc
писать (pi-sat)=viết
петь (pyet)=hát
танцевать (tan-tse-vat)=nhảy
счастливый (shas-tli-vyi)=vui vẻ
грустный (grus-tnyy)=buồn bã
большой (bal-shoi)=lớn
маленький (ma-lyen-ki)=nhỏ
горячий (ga-rya-chiy)=nóng
холодный (ha-lod-nyy)=lạnh
хороший (ha-ro-shiy)=tốt
плохой (pla-khoi)=xấu